xx######
###    #
#  $$$ #
# ## # #
#  ... #
### @ ##
xx#####x
