#####xxx
#@ .####
#. .   #
#$$ $  #
#  #####
#  #xxxx
####xxxx
