######xxxxx
#  @ #xxxxx
###$$######
#    .    #
#   $     #
##.       #
x#.       #
x##########
