x#####xx
x# @ ###
##$$$$ #
#  # # #
#  ....#
#  #   #
########
