#####xxxx
#   ####x
# $    ##
##$#*.  #
# $ ..  #
# @ ##  #
#########
