xx####xxxxxx
###  #xxxxxx
#@ .$#######
#   $     .#
# # $  #####
#      #  .#
#          #
#          #
############
