xxxx####xxxx
#####  ###xx
#   #   @###
# #    #$  #
#   ##$ $  #
#  ... #   #
#   ########
#####xxxxxxx
