#########
#   #   #
#  ...  #
## ## ###
x#  $$$ #
x#  @   #
x########
