x#######x
x#  #  ##
##..    #
# ..#   #
# ### ###
#   $$$ #
##### $ #
xxxx# @ #
xxxx#####
