xx####x
xx#@ #x
###$$##
#    .#
#   $ #
##. ###
x#. #xx
x####xx
