##########x
#    #   #x
#   .....#x
#   ### ###
#    #    #
#### #$$$ #
xx#   $@$ #
xx#   #  ##
xx########x
